O------------------O
I   1        I  A  I
I  1D1       I     I
I   1        O     I
I                  I
I                  I
M                  I
I                  I
O--- O   X         I
I    I             I
I1   I            @I
O----O-------------O