O------------------O
I            I  A  I
I            I     I
I            O     I
I                  I
I                  I
M                  I
I                  I
O--- O   X         I
I    I             I
I1   I            @I
O----O-------------O