O----M-------------O
I              B   I
I 1                I
I    I-----I       I
I    I  X  I 1 I   I
I        I----I    I
I                C I
I  A               I
I        -- ---OO  I
I      O       @O 1I
I        OOOOOOOO  I
O------------------O