O--------O---O-----O
I        IX       1I
I A      O---O   C I
I--O         O--O -O
M      OO---O      I
I       I D I      I
IO          I      I
I      OI   I     OI
I      OO---O      I
O- --OO       O ---O
I    1I   @   I   1I
O-----O-------O----O